(Uracil,Uracil,Cytosine)	Phe
(Uracil,Uracil,Adenine)	Leu
(Uracil,Uracil,Uracil)	Phe
(Uracil,Uracil,Guanine)	Leu
(Cytosine,Uracil,Uracil)	Leu
(Cytosine,Uracil,Cytosine)	Leu
(Cytosine,Uracil,Adenine)	Leu
(Cytosine,Uracil,Guanine)	Leu
(Adenine,Uracil,Uracil)	Iso
(Adenine,Uracil,Cytosine)	Iso
(Adenine,Uracil,Adenine)	Iso
(Adenine,Uracil,Guanine)	Met
(Guanine,Uracil,Uracil)	Val
(Guanine,Uracil,Cytosine)	Val
(Guanine,Uracil,Adenine)	Val
(Guanine,Uracil,Guanine)	Val
(Uracil,Cytosine,Uracil)	Ser
(Uracil,Cytosine,Cytosine)	Ser
(Uracil,Cytosine,Adenine)	Ser
(Uracil,Cytosine,Guanine)	Ser
(Cytosine,Cytosine,Uracil)	Pro
(Cytosine,Cytosine,Cytosine)	Pro
(Cytosine,Cytosine,Adenine)	Pro
(Cytosine,Cytosine,Guanine)	Pro
(Adenine,Cytosine,Uracil)	Thr
(Adenine,Cytosine,Cytosine)	Thr
(Adenine,Cytosine,Adenine)	Thr
(Adenine,Cytosine,Guanine)	Thr
(Guanine,Cytosine,Uracil)	Ala
(Guanine,Cytosine,Cytosine)	Ala
(Guanine,Cytosine,Adenine)	Ala
(Guanine,Cytosine,Guanine)	Ala
(Uracil,Adenine,Uracil)	Tyr
(Uracil,Adenine,Cytosine)	Tyr
(Uracil,Adenine,Adenine)	Stop
(Uracil,Adenine,Guanine)	Stop
(Cytosine,Adenine,Uracil)	His
(Cytosine,Adenine,Cytosine)	His
(Cytosine,Adenine,Adenine)	Gln
(Adenine,Adenine,Uracil)	Gln
(Adenine,Adenine,Cytosine)	Asn
(Adenine,Adenine,Adenine)	Lys
(Adenine,Adenine,Guanine)	Lys
(Guanine,Adenine,Uracil)	Asp
(Guanine,Adenine,Cytosine)	Asp
(Guanine,Adenine,Adenine)	Glu
(Guanine,Adenine,Guanine)	Glu
(Uracil,Guanine,Uracil)	Cys
(Uracil,Guanine,Cytosine)	Cys
(Uracil,Guanine,Adenine)	Stop
(Uracil,Guanine,Guanine)	Try
(Cytosine,Guanine,Uracil)	Arg
(Cytosine,Guanine,Cytosine)	Arg
(Cytosine,Guanine,Adenine)	Arg
(Cytosine,Guanine,Guanine)	Arg
(Adenine,Guanine,Uracil)	Ser
(Adenine,Guanine,Guanine)	Ser
(Adenine,Guanine,Adenine)	Arg
(Adenine,Guanine,Cytosine)	Arg
(Guanine,Guanine,Uracil)	Gly
(Guanine,Guanine,Cytosine)	Gly
(Guanine,Guanine,Adenine)	Gly
(Guanine,Guanine,Guanine)	Gly